10 10
SXXXXXX.XX
....B....X
.XXXXXX..X
.XX.....XX
.XX.XXX..X
.XX.XXX..X
.XX......X
.XXXXXX..X
.G......T.
XXXXXGXX.X