33 65
XXXXXXXXXXXXXXXXXXXXXXXXXXXXXXXXXXXXXXXXXXXXXXXXXXXXXXXXXXXXXXXXX
XS..........X...................................................X
X...XXXXX...X...XXXXXXXXXXXXXXXXXXXXXXXXXXXXXXXXXXXXXXXXX...X...X
X...X...X.......X...X...X...X...X.......X.......X.......X...X...X
X...X...XXXXXXXXX...X...X...X...X...X...X...X...X...X...X...X...X
X...X.......X.......................X.......X.......X.......X...X
X...XXXXX...X...XXXXX...X...X...X...XXXXXXXXXXXXXXXXXXXXXXXXX...X
X...X.......X...X...X...X...X...X...X...........X.......X...X...X
X...X...X...X...X...XXXXX...XXXXXXXXX...XXXXXXXXX...X...X...X...X
X...X...X.......X.......X...X.......X...............X.......X...X
XXXXXXXXXXXXXXXXXXXXXXXXXXXXXXXXXXXXX...XXXXXXXXXXXXXXXXX...X...X
X...................................X.......X...............X...X
X...XXXXXXXXXXXXXXXXXXXXXXXXXXXXX...X...XXXXX...XXXXXXXXXXXXX...X
X...X.......X...................X...X.......X...............X...X
X...XXXXXXXXX...XXXXXXXXXXXXXXXXX...X...XXXXX...XXXXXXXXX...X...X
X...X.......X...X...........X.......X...X...................X...X
X...XXXXXXXXX...X...XXXXX...X...X...XXXXX...XXXXXXXXXXXXX...X...X
X...X.......X...X...XT......X.......X...X...X...........X...X...X
X...XXXXXXXXX...X...XXXXX...XXXXXXXXX...XXXXX...XXXXXXXXX...X...X
X...X...X...................X...X...X...........X...........X...X
X...X...X...XXXXXXXXXXXXXXXXX...X...XXXXXXXXX...XXXXXXXXX...X...X
X...X...X.......................X...........X...........X...X...X
X...XXXXX...X...XXXXXXXXXXXXXXXXX...XXXXXXXXXXXXX...X...X...X...X
X...........X...............X...................X...X...X...X...X
XXXXXXXXX...X...X...XXXXXXXXX...XXXXXXXXXXXXXXXXX...X...X...X...X
X.......X...X...X...........X...............X...X.......X...X...X
X...X...X...X...X...XXXXXXXXX...XXXXXXXXXXXXX...XXXXX...X...X...X
X...X...........X...........X...X...X...............X.......X...X
X...X...XXXXXXXXXXXXXXXXXXXXX...X...XXXXXXXXX...X...XXXXX...X...X
X...X...X...................X.......X.......X...X.......X...X...X
X...X...X...XXXXXXXXX...X...XXXXXXXXX...X...X...X...XXXXXXXXX...X
X...X...................X...............X.......................X
XXXXXXXXXXXXXXXXXXXXXXXXXXXXXXXXXXXXXXXXXXXXXXXXXXXXXXXXXXXXXXXXX
